R 1280        720


C  98, 119, 126
F   11, 19, 10

S ./sprites/ch2.xpm

NO ./sprites/n.xpm
SO ./sprites/s.xpm
WE ./sprites/w.xpm
EA ./sprites/e.xpm


    11111111111111111111111111111
    1 1 1000000100000000000000001
    11111000000100001020W00020001
        1000000000001000000000001
111111111000000000001000000000001
100000000000000111111110000011111
100000000000000100000000000001
111111111000001100000000000001
        1000110000000020002001
111111111000100000000000000001
100000000000100000000011111111
10000000000000000000001 1 1 1 1
100001110000011100000011111111
100001 1000001 100000000000001
111111 1111111 111111111111111